NO texture_1
SO texture_2
WE texture_3
EA texture_4

F 220,100,0
C 225,30,0

                1111111111111111111111111
                1W00000000110000000000001
                1011000001110000000000001
                1001000000000000000000001
        11111111101100000111000000000000111111111
        10000000001100000111000000000111111111111
        11110111111111011100000000000000000010001
        11110111111111011101010010000000000000001
        11000000110101011100000010000000000000001
        11111111100000000110000000000000111111111
                1000000000000000110101001
                1100000111010101111101111
                11110111 1110101 10111101
                11111111 1111111 11111111
