NO texture_1
SO texture_2
WE texture_3
EA texture_4

F 220,100,0
C 225,30,0

111111111
1S0000001
101100001
100100001
111111111
